access control entri => ﻿Access Control Entry
access control list => Access Control List
ac => ACE
acl => ACL
acpi => ACPI
adsl => ADSL
af => AFS
apc => APC
api => API
applic program interfac => Application Program Interface
asynchron procedur call => Asynchronous Procedure Call
av-диск => AV-диск
basic input output system => Basic Input Output System
berkelei unix => Berkeley UNIX
bff => BFFS
bio => BIOS
bsd => BSD
bss => BSS
с-список => С-список
cc-numa => CC-NUMA
cd-r => CD-R
cd-rom => CD-ROM
cd-rom vtoc => CD-ROM VTOC
cd-rom многосеансов => CD-ROM многосеансовый
cd-rom сеанс => CD-ROM сеанс
cd-rom файлов систем => CD-ROM файловая система
cd-rom XA => CD-ROM XA
cd-rw => CD-RW
cert => CERT
cmos-памя => CMOS-память
cm => CMS
compat time share system => Compatible Time Sharing System
corba => CORBA
cp/m => CP/M
ctss => CTSS
d-пространств => D-пространство
dacl => DACL
data encrypt standard => Data Encryption Standard
defer procedur call => Deferred Procedure Call
de => DES
dib => DIB
digit versatil disk => Digital Versatile Disk
digit video => Digital Video
digit video disk => Digital Video Disk
direct memori access => Direct Memory Access
directx => DirectX
discretionari access control list => Discretionary Access Control List
dll => DLL
dma => DMA
dn => DNS
dpc => DPC
dsm => DSM
DV => DV
dvd => DVD
dynamic-link librari => Dynamic-Link Library
ecc => ECC
edf => EDF
ef => EFS
encrypt file system => Encrypting File System
esc-последовательн => ESC-последовательность
ethernet => Ethernet
fat-16 => FAT-16
fat-32 => FAT-32
fat-таблиц => FAT-таблица
fifo => FIFO
finger daemon => finger daemon
firewir => FireWire
flash ram => flash RAM
fortran => FORTRAN
gdi => GDI
gid => GID
globe => Globe
gnu => GNU
gnu public licens => GNU Public License
gpl => GPL
group identif => Group IDentification
gui => GUI
hal => HAL
hardwar abstract layer => Hardware Abstraction Layer
high sierra => High Sierra
l-пространств => l-пространство
i-узел => i-узел
ibm 1401 => IBM 1401
ibm 7094 => IBM 7094
ibm PC => IBM PC
ibm/360 => IBM/360
id => IDE
idl => IDL
ieee 1394 => IEEE 1394
iiop => IIOP
instruct set architectur => Instruction Set Architecture
integr drive electron => Integrated Drive Electronics
interprocess commun => InterProcess Communication
intrins => Intrinsics
ipc => IPC
irp => IRP
isa => ISA
iso 9660 => ISO 9660
iso 9660 расширен joiiet => ISO 9660 расширения Joiiet
iso 9660 рок-ридж расширен => ISO 9660 Рок-Ридж расширения
itu => ITU
javaspac => JavaSpace
jdk => JDK
jini => Jini
jini аренд => Jini аренда
jini протокол обнаружен => Jini протокол обнаружения
jini служб поиск => Jini служба поиска
joiiet расширен => Joiiet расширения
jpeg => JPEG
jvm => JVM
jvm-код => JVM-код
lba => LBA
ldt => LDT
lf => LFS
linda => Linda
linda пространств кортеж => Linda пространство кортежей
linda шаблон => Linda шаблон
linux => Linux
linux алгоритм планирован => Linux алгоритм планирования
linux поток => Linux потоки
linux управлен памят => Linux управление памятью
linux файлов систем => Linux файловая система
lru => LRU
master file tabl => Master File Table
md5 => MD5
memori manag unit => Memory Management Unit
message-pass interfac => Message-Passing Interface
mft => MFT
minix => MINIX
mmu => MMU
motif => Motif
mpeg => MPEG
mpeg макроблок => MPEG макроблок
mpi => MPI
MS do => MS DOS
MS do эмуляц в window => MS DOS эмуляция в Windows
multic => MULTICS
nc-numa => NC-NUMA
new technolog file system => New Technology File System
nf => NFS
nf архитектур => NFS архитектура
nf протокол => NFS протоколы
nf реализац => NFS реализация
nfu => NFU
nru => NRU
ntf => NTFS
numa => NUMA
orb => ORB
os/360 => OS/360
os/360 дефект систем безопасност => OS/360 дефекты системы безопасности
osf => OSF
pci => PCI
pda => PDA
pdp-11 => PDP-11
pentium => Pentium
pff => PFF
pic => PIC
pid => PID
plug and plai => plug and play
posit independ code => Position Independent Code
posix => POSIX
posix управлен поток => POSIX управление потоками
psw => PSW
г-узел => г-узел
raid => RAID
ram => RAM
random access memori => Random Access Memory
rm => RMS
root => root
rpc => RPC
rsa => RSA
rwx-бит => rwx-биты
sacl => SACL
scan-edf => scan-EDF
script kiddi => script kiddy
scsi => SCSI
secam => SECAM
secur identifi => Security IDentifier
setuid => SETUID
sha => SHA
shell => shell
sid => SID
sled => SLED
slim => SLIM
smr => SMR
starvat => starvation
svid => SVID
system access control list => System Access Control List
system V => System V
tcb => TCB
tcp => TCP
tcp/ip => TCP/IP
tenex => TENEX
termcap => termcap
tlb => TLB
tops-20 => TOPS-20
uart => UART
udr => UDR
Ul => Ul
uid => UID
uma => UMA
unic => UNICS
unix => UNIX
unix berkelei => UNIX Berkeley
unix pdp-11 => UNIX PDP-11
unix алгоритм планирован => UNIX алгоритм планирования
unix безопасн => UNIX безопасность
unix ввод-вывод => UNIX ввод-вывод
unix дефект систем безопасност => UNIX дефекты системы безопасности
unix загрузк => UNIX загрузка
unix задач => UNIX задачи
unix интерфейс => UNIX интерфейсы
unix истор => UNIX история
unix обзор => UNIX обзор
unix оболочк => UNIX оболочка
unix переносим => UNIX переносимая
unix поток => UNIX потоки
unix процесс => UNIX процессы
unix сет => UNIX сеть
unix стандартн => UNIX стандартная
unix страничн подкачк => UNIX страничная подкачка
unix структур ядр => UNIX структура ядра
unix управлен памят => UNIX управление памятью
unix утилит => UNIX утилиты
unix файлов систем => UNIX файловая система
unix файлов систем V7 => UNIX файловая система V7
unix intern => UNIX International
upcal => upcall
url => URL
usb => USB
user identif => User IDentification
v-узел => v-узел
vad => VAD
venu => venus
vice => vice
virtual address descriptor => Virtual Address Descriptor
vm/370 => VM/370
web-браузер => web-браузер
web-страниц => web-страница
widget => widget
win32 api => Win32 API
window => Windows
window mft => Windows MFT
window алгоритм замещен страниц => Windows алгоритм замещения страниц
window безопасн => Windows безопасность
window ввод-вывод => Windows ввод-вывод
window главн файлов таблиц => Windows главная файловая таблица
window драйвер устройств => Windows драйверы устройств
window загрузк => Windows загрузка
window исполня систем => Windows исполняющая система
window истор => Windows история
window критическ секц => Windows критическая секция
window межпроцессн взаимодейств => Windows межпроцессное взаимодействие
window обработк страничн прерыван => Windows обработка страничных прерываний
window объект => Windows объект
window планирован => Windows планирование
window программирован => Windows программирование
window процесс => Windows процессы
window реестр => Windows реестр
window сокет => Windows сокет
window структур систем => Windows структура системы
window управлен памят => Windows управление памятью
window файлов систем => Windows файловая система
window ядр => Windows ядро
window 95 => Windows 95
window 98 => Windows 98
window driver model => Windows Driver Model
window Me => Windows Me
window millennium edit => Windows Millennium Edition
window NT => Windows NT
wsciock => WSCIock
X window system => X Window System
х-клиент => Х-клиент
х-сервер => Х-сервер
x-термина => X-терминал
xlib => Xlib
абсолютн им пут => абсолютное имя пути
абсолютн пут => абсолютный путь
автодозвон => автодозвон
автомонтировк => автомонтировка
агент => агент
адаптер => адаптер
объект => объект
адресн пространств => адресное пространство
активац планировщик => активация планировщика
ожидан => ожидание
сообщен => сообщение
алгоритм => алгоритм
алгоритм md5 => алгоритм MD5
алгоритм pff => алгоритм PFF
алгоритм nfu => алгоритм NFU
алгоритм scan-edf => алгоритм scan-EDF
алгоритм ssf => алгоритм SSF
алгоритм балансировк нагрузк => алгоритм балансировки нагрузки
алгоритм балансировк нагрузк графов => алгоритм балансировки нагрузки графовый
алгоритм балансировк нагрузк инициируем => алгоритм балансировки нагрузки инициируемый
алгоритм балансировк нагрузк торг => алгоритм балансировки нагрузки торгов
алгоритм банкир => алгоритм банкира
алгоритм банкир нескольк вид ресурс => алгоритм банкира несколько видов ресурсов
алгоритм банкир один вид ресурс => алгоритм банкира один вид ресурсов
алгоритм быстр подходя => алгоритм быстрый подходящий
алгоритм замещен страниц => алгоритм замещения страниц
алгоритм замещен страниц fifo => алгоритм замещения страниц FIFO
алгоритм замещен страниц lru => алгоритм замещения страниц LRU
алгоритм замещен страниц nfu => алгоритм замещения страниц NFU
алгоритм замещен страниц nru => алгоритм замещения страниц NRU
алгоритм замещен страниц pff => алгоритм замещения страниц PFF
алгоритм замещен страниц unix => алгоритм замещения страниц UNIX
алгоритм замещен страниц window => алгоритм замещения страниц Windows
алгоритм замещен страниц wsciock => алгоритм замещения страниц WSCIock
алгоритм замещен страниц втор попытк => алгоритм замещения страниц вторая попытка
алгоритм замещен страниц глобальн => алгоритм замещения страниц глобальный
алгоритм замещен страниц локальн => алгоритм замещения страниц локальный
алгоритм замещен страниц оптимальн => алгоритм замещения страниц оптимальный
алгоритм замещен страниц рабоч набор => алгоритм замещения страниц рабочий набор
алгоритм замещен страниц резюм => алгоритм замещения страниц резюме
алгоритм замещен страниц старен => алгоритм замещения страниц старение
алгоритм замещен страниц час => алгоритм замещения страниц часы
алгоритм перв подходя участок => алгоритм первый подходящий участок
алгоритм петерсон => алгоритм Петерсона
алгоритм планирован => алгоритм планирования
алгоритм планирован edf => алгоритм планирования EDF
алгоритм планирован linux => алгоритм планирования Linux
алгоритм планирован rm => алгоритм планирования RMS
алгоритм планирован unix => алгоритм планирования UNIX
алгоритм планирован window => алгоритм планирования Windows
алгоритм планирован гарантирова планирован => алгоритм планирования гарантированное планирование
алгоритм планирован двухуровнев => алгоритм планирования двухуровневый
алгоритм планирован задач => алгоритм планирования задачи
алгоритм планирован интерактивн систем => алгоритм планирования интерактивные системы
алгоритм планирован категор => алгоритм планирования категории
алгоритм планирован кратчайш задач — перв => алгоритм планирования кратчайшая задача — первая
алгоритм планирован лотере => алгоритм планирования лотерея
алгоритм планирован многомашин систем => алгоритм планирования многомашинная система
алгоритм планирован мультимед => алгоритм планирования мультимедиа
алгоритм планирован мультипроцессор => алгоритм планирования мультипроцессор
алгоритм планирован наименьш оста врем выполнен => алгоритм планирования наименьшее оставшееся время выполнения
алгоритм планирован нескольк очеред => алгоритм планирования несколько очередей
алгоритм планирован перв пришел — перв обслуж => алгоритм планирования первым пришел — первым обслужен
алгоритм планирован планирован поток => алгоритм планирования планирование потоков
алгоритм планирован приоритетн планирован => алгоритм планирования приоритетное планирование
алгоритм планирован реальн времен => алгоритм планирования реального времени
алгоритм планирован родствен => алгоритм планирования родственное
алгоритм планирован систем пакетн обработк => алгоритм планирования системы пакетной обработки
алгоритм планирован справедлив планирован => алгоритм планирования справедливое планирование
алгоритм планирован трехуровнев планирован => алгоритм планирования трехуровневое планирование
алгоритм планирован циклическ планирован => алгоритм планирования циклическое планирование
алгоритм распределен процессор => алгоритм распределения процессоров
сам неподходя участок => самый неподходящий участок
сам подходя участок => самый подходящий участок
алгоритм след подходя участок => алгоритм следующий подходящий участок
алгоритм управлен допуск => алгоритм управления допуском
алгоритм час => алгоритм часы
алгоритм шифрован rsa => алгоритм шифрования RSA
алфавитно-цифров термина => алфавитно-цифровой терминал
аналогово-цифров преобразовател => аналогово-цифровой преобразователь
аномал билэд => аномалия Билэди
антивирусн техник => антивирусная техника
проверк поведен => проверка поведения
проверк целостност => проверка целостности
антивирусн техник сканер вирус => антивирусная техника сканер вирусов
аппаратн част диск => аппаратная часть дисков
аппаратн част таймер => аппаратная часть таймеров
аппаратн част устройств ввода-вывод => аппаратная часть устройств ввода-вывода
аппаратно-независим растров изображен => аппаратно-независимое растровое изображение
аппаратн обеспечен => аппаратное обеспечение
аппаратн обеспечен ввода-вывод => аппаратное обеспечение ввода-вывода
аппаратн обеспечен ввода-вывод диск => аппаратное обеспечение ввода-вывода диск
аппаратн обеспечен ввода-вывод диспл => аппаратное обеспечение ввода-вывода дисплей
аппаратн обеспечен ввода-вывод клавиатур => аппаратное обеспечение ввода-вывода клавиатура
аппаратн обеспечен ввода-вывод мыш => аппаратное обеспечение ввода-вывода мышь
аппаратн обеспечен компьютер => аппаратное обеспечение компьютера
апплет => апплет
архивац => архивация
архитектур => архитектура
архитектурн согласован => архитектурная согласованность
асимметричн цифров абонентск лин => асимметричная цифровая абонентская линия
асинхрон выз => асинхронный вызов
асинхрон выз процедур => асинхронный вызов процедуры
ассоциативн памя => ассоциативная память
атак с помощ переполнен буфер => атака с помощью переполнения буфера
атак систем безопасност => атака системы безопасности
атак систем безопасност логическ бомб => атака системы безопасности логическая бомба
атак систем безопасност переполнен буфер => атака системы безопасности переполнение буфера
атак систем безопасност потайн двер => атака системы безопасности потайная дверь
атак систем безопасност троянск кон => атака системы безопасности троянский конь
атак систем безопасност фальшив программ регистрац => атака системы безопасности фальшивая программа регистрации
атрибут файл => атрибут файла
аутентификац => аутентификация
аутентификац пользовател => аутентификация пользователя
аутентификац пользовател оклик-отз => аутентификация пользователя оклик-отзыв
аутентификац пользовател с использован => аутентификация пользователя с использованием
базов зап => базовая запись
базов систем ввода-вывод => базовая система ввода-вывода
базов приоритет => базовый приоритет
базов регистр => базовый регистр
барьер => барьер
безопасн состоян => безопасное состояние
безопасн => безопасность
безопасн java => безопасность Java
безопасн unix => безопасность UNIX
безопасн window => безопасность Windows
безопасн вызов win32 api => безопасность вызовы Win32 API
беспроводн связ => беспроводная связь
библиотек совместн доступ => библиотека совместного доступа
биграмм => биграмма
бит setuid => бит SETUID
бит ожидан активизац => бит ожидания активизации
бит присутствия/отсутств => бит присутствия/отсутствия
битов карт => битовая карта
битов масс => битовый массив
блок управлен процесс => блок управления процессом
блокировк без монополизац => блокировка без монополизации
блокировк с монополизац => блокировка с монополизацией
блокировк файл => блокировка файл
блокир сет => блокирующая сеть
блокир выз => блокирующий вызов
блочн кэширован => блочное кэширование
блочн устройств => блочное устройство
блочн кэш => блочный кэш
блочн специальн файл => блочный специальный файл
больш адресн пространств => большое адресное пространство
бригадн планирован => бригадное планирование
брокер объектн запрос => брокер объектных запросов
буфер быстр преобразован адрес => буфер быстрого преобразования адреса
буфер быстр преобразован адрес программн управлен => буфер быстрого преобразования адреса программное управление
буферизац => буферизация
буферизац двойн => буферизация двойная
буферн кэш => буферный кэш
ввод-вывод => ввод-вывод
ввод-вывод dma => ввод-вывод DMA
ввод-вывод unix => ввод-вывод UNIX
ввод-вывод window => ввод-вывод Windows
ввод-вывод отобража на памя => ввод-вывод отображаемый на память
ввод-вывод программн обеспечен => ввод-вывод программное обеспечение
ввод-вывод программн уровн => ввод-вывод программные уровни
ввод-вывод прям доступ к памят => ввод-вывод прямой доступ к памяти
ввод-вывод управля прерыван => ввод-вывод управляемый прерываниями
вектор прерыван => вектор прерываний
вектор ресурс => вектор ресурсов
векторн график => векторная графика
венгерск нотац => венгерская нотация
взаимн исключен => взаимное исключение
взаимн исключен активн ожидан => взаимное исключение активное ожидание
взаимн исключен алгоритм петерсон => взаимное исключение алгоритм Петерсона
взаимн исключен запрещен прерыван => взаимное исключение запрещение прерываний
взаимн исключен перемен блокировк => взаимное исключение переменные блокировки
взаимн исключен строг чередован => взаимное исключение строгое чередование
взаимоблокировк => взаимоблокировка
взаимоблокировк определен => взаимоблокировка определение
взаимоблокировк услов => взаимоблокировка условия
взломщик => взломщик
виде по заказ => видео по заказу
виде поступательн => видео поступательное
виде смеша сигна => видео смешанный сигнал
виде цифров => видео цифровое
виде чересстрочн развертк => видео чересстрочная развертка
видеооз => видеоОЗУ
видеоконтроллер => видеоконтроллер
видеопамя => видеопамять
видеосервер => видеосервер
виртуальн машин => виртуальная машина
виртуальн машин java => виртуальная машина Java
виртуальн памя => виртуальная память
виртуальн адресн пространств => виртуальное адресное пространство
виртуальн адрес => виртуальный адрес
вирус => вирус
вирус атак отказ в обслуживан => вирус атака отказа в обслуживании
вирус восстановлен => вирус восстановление
вирус драйвер устройств => вирус драйвера устройства
вирус заража исходн текст программ => вирус заражающий исходные тексты программ
вирус компаньон => вирус компаньон
вирус макрос => вирус макрос
вирус метод борьб => вирус методы борьбы
вирус паразитическ => вирус паразитический
вирус перезаписыва => вирус перезаписывающий
вирус пипетк => вирус пипетка
вирус полезн нагрузк => вирус полезная нагрузка
вирус полиморфн => вирус полиморфный
вирус полостн => вирус полостной
вирус поража загрузочн сектор => вирус поражающий загрузочный сектор
вирус предохранен => вирус предохранение
вирус резидентн => вирус резидентный
сценар нанесен ущерб => сценарии нанесения ущерба
сценар распространен => сценарии распространения
вирусн сканер => вирусный сканер
вмонтирова файлов систем => вмонтированная файловая система
внешн фрагментац => внешняя фрагментация
внутрен фрагментац => внутренняя фрагментация
возможн => возможность
волокн => волокно
волшебн символ => волшебный символ
впускн планировщик => впускной планировщик
времен поток => временный поток
врем отклик => время отклика
врем связыван => время связывания
всеобщ скоординирова врем => всеобщее скоординированное время
всплыва поток => всплывающий поток
встроен систем => встроенные системы
втор попытк => вторая попытка
второстепен устройств => второстепенное устройство
выделен устройств ввода-вывод => выделенное устройство ввода-вывода
win32 api безопасн => Win32 API безопасность
win32 api ввод-вывод => Win32 API ввод-вывод
win32 api управлен => Win32 API управление
win32 api файлов систем => Win32 API файловая система
выз удален процедур => вызов удаленной процедуры
высоконадежн вычислительн баз => высоконадежная вычислительная база
выход из тупик => выход из тупика
выход из тупик откат => выход из тупика откат
выход из тупик принудительн выгрузк ресурс => выход из тупика принудительная выгрузка ресурса
выход из тупик уничтожен процесс => выход из тупика уничтожение процессов
гарантирова планирован => гарантированное планирование
гибк систем реальн времен => гибкая система реального времени
гиперкуб => гиперкуб
гиперссылк => гиперссылка
главн загрузочн зап => главная загрузочная запись
главн файлов таблиц => главная файловая таблица
главн устройств => главное устройство
глобальн сет => глобальная сеть
глобальн таблиц дескриптор => глобальная таблица дескрипторов
голодан => голодание
графическ адаптер => графический адаптер
графическ интерфейс пользовател => графический интерфейс пользователя
графическ интерфейс пользовател программн обеспечен => графический интерфейс пользователя программное обеспечение
грозд рабоч станц => гроздь рабочих станций
групп => группа
проникновен => проникновения
процесс => процесс
цилиндр => цилиндр
грязн бит => грязный бит
двоичн семафор => двоичный семафор
двоичн экспоненциальн откат => двоичный экспоненциальный откат
двойн буферизац => двойная буферизация
двойн косвен блок => двойной косвенный блок
двойн тор => двойной тор
двухуровнев планирован => двухуровневое планирование
двухфазов блокирован => двухфазовое блокирование
дейтаграммн служб => дейтаграммная служба
дейтаграммн служб с подтвержден => дейтаграммная служба с подтверждениями
декодирован => декодирование
демон => демон
запис модифицирова страниц => записи модифицированных страниц
запис отображен страниц => записи отображенных страниц
менеджер балансов множеств => менеджер балансового множества
менеджер рабоч набор => менеджер рабочих наборов
демон печат => демон печати
поток обнулен страниц => поток обнуления страниц
поток свопер => поток свопера
демон страничн => демон страничный
дескриптор => дескриптор
дескриптор защит => дескриптор защиты
дескриптор процесс => дескриптор процесса
дескриптор файл => дескриптор файла
детишк со сценар => детишки со сценариями
дефектн блок => дефектный блок
дефектн сектор => дефектный сектор
дефект систем безопасност => дефекты системы безопасности
дефект систем безопасност os/360 => дефекты системы безопасности OS/360
дефект систем безопасност tenex => дефекты системы безопасности TENEX
дефект систем безопасност unix => дефекты системы безопасности UNIX
децибел => децибел
джиггер => джиггер
джифф => джиффи
диаметр => диаметр
динамическ подсоединя библиотек => динамически подсоединяемая библиотека
динамическ диск => динамический диск
диод плох новост => диод плохих новостей
диск => диск
диск cd-r => диск CD-R
диск cd-rom => диск CD-ROM
диск cd-rw => диск CD-RW
диск dvd => диск DVD
диск id => диск IDE
диск аппаратн част => диск аппаратная часть
диск магнитн => диск магнитный
диск раздел => диск раздел
диск форматирован => диск форматирование
диск чередован сектор => диск чередование секторов
дисков квот => дисковая квота
дисков ферм => дисковая ферма
дисков планирован => дисковое планирование
динамическ => динамическое
мультимед => мультимедиа
статическ => статическое
дискрецион управлен доступ => дискреционное управление доступом
диспетчер => диспетчер
диспетчер памят => диспетчер памяти
дисциплин лин связ => дисциплина линии связи
дом защит => домен защиты
дорожк => дорожка
доступ к файл => доступ к файлам
доступн систем => доступность системы
дочерн процесс => дочерний процесс
драйвер устройств => драйвер устройства
драйвер устройств window => драйвер устройства Windows
драйвер устройств единообразн интерфейс => драйвер устройства единообразный интерфейс
драйвер-фильтр => драйвер-фильтр
дружествен интерфейс => дружественный интерфейс
единиц измерен => единицы измерения
желт книг => Желтая книга
жестк связ => жесткая связь
жестк систем реальн времен => жесткая система реального времени
завершен процесс => завершение процесса
зависан процесс => зависание процесса
заголовок сектор => заголовок сектора
заголовочн файл => заголовочный файл
загрузк unix => загрузка UNIX
загрузк window => загрузка Windows
загрузочн блок => загрузочный блок
загрузочн сектор => загрузочный сектор
задан => задание
задан window => задание Windows
задатчик последовательност => задатчик последовательности
закон ципф => закон Ципфа
замещен страниц по запрос => замещение страниц по запросу
запрещен прерыван => запрещение прерываний
захват цикл => захват цикла
зашифрова текст => зашифрованный текст
защит памят => защита памяти
защит парол в систем unix => защита паролей в системе UNIX
защищен систем => защищенная система
зелен книг => Зеленая книга
злоумышленик => злоумышленник
значен => значение
зуб вампир => зуб вампира
идеальн тасован => идеальное тасование
идентификатор безопасност => идентификатор безопасности
идентификатор групп => идентификатор группы
идентификатор пользовател => идентификатор пользователя
идентификатор процесс => идентификатор процесса
идентификац по длин пальц => идентификация по длине пальцев
иерарх памят => иерархия памяти
иерарх процесс => иерархия процессов
избежан взаимоблокировок => избежание взаимоблокировок
избежан взаимоблокировок нескольк вид ресурс => избежание взаимоблокировок несколько видов ресурсов
именован => именование
именован файл => именование файлов
им пут => имя пути
им пут абсолютн => имя пути абсолютное
им пут относительн => имя пути относительное
инверс приоритет => инверсия приоритета
инвертирова таблиц страниц => инвертированная таблица страниц
индекс-узел => индекс-узел
инкрементн архивац => инкрементная архивация
инкрементн резервн коп => инкрементная резервная копия
интернет => Интернет
интернет-протокол => Интернет-протокол
интернет-черв => Интернет-червь
интерпретатор команд => интерпретатор команд
интерпретац => интерпретация
интерфейс => интерфейс
интерфейс win32 api => интерфейс Win32 API
интерфейс виртуальн памят => интерфейс виртуальной памяти
интерфейс графическ устройств => интерфейс графических устройств
интерфейс драйвер-ядр => интерфейс драйвер-ядро
интерфейс драйвер => интерфейс драйвера
интерфейс передач сообщен => интерфейс передачи сообщений
интерфейс пользовател => интерфейс пользователя
интерфейс прикладн программ => интерфейс прикладных программ
интерфейс системн вызов => интерфейс системных вызовов
исполня систем => исполняющая система
использован поток => использование потоков
истин врем => истинное время
кадр => кадр
кана => канал
каноническ реж => канонический режим
карма компьютер => карманный компьютер
карт клавиш => карта клавиш
карт памят => карта памяти
карт храня информац => карта хранящая информацию
каталог => каталог
каталог ср/м => каталог СР/М
каталог iso 9660 => каталог ISO 9660
каталог ms-do => каталог MS-DOS
каталог unixv7 => каталог UNIXV7
каталог window => каталог Windows
каталог window 98 => каталог Windows 98
каталог двухуровнев систем => каталог двухуровневая система
каталог иерархическ систем => каталог иерархическая система
каталог корнев => каталог корневой
каталог одноуровнев систем => каталог одноуровневая система
каталог рабоч => каталог рабочий
каталог распределен систем => каталог распределенная система
каталог реализац => каталог реализация
каталог спулер => каталог спулера
каталог текущ => каталог текущий
каталог спулинг => каталог спулинга
каталогов мультипроцессор => каталоговый мультипроцессор
качеств обслуживан => качество обслуживания
квант => квант
квантован => квантование
квот => квота
кластерн компьютер => кластерный компьютер
клиентск процесс => клиентский процесс
клиентск суррогат => клиентский суррогат
ключ реестр => ключ реестр
ключ файл => ключ файл
ключ шифрован => ключ шифрования
код исправлен ошибок => код исправления ошибок
кодирован => кодирование
кодирован звук => кодирование звука
кодирован изображен => кодирование изображения
кодов страниц => кодовая страница
кодово-импульсн модуляц => кодово-импульсная модуляция
козел отпущен => козел отпущения
кольц защит => кольцо защиты
команд trar => команда TRAR
команд главн программист => команда главного программиста
команд защит => команда защиты
команд тигр => команда тигров
коммутац => коммутация
коммутац канал => коммутация каналов
коммутац пакет с промежуточн хранен => коммутация пакетов с промежуточным хранением
компакт-диск => компакт-диск
компьютер втор поколен => компьютер второе поколение
компьютер перв поколен => компьютер первое поколение
компьютер пита от батар => компьютер питающийся от батарей
компьютер трет поколен => компьютер третье поколение
компьютер четверт поколен => компьютер четвертое поколение
конвейер => конвейер
конечн автомат => конечный автомат
контекст устройств => контекст устройства
контрмер => контрмеры
контроллер устройств => контроллер устройства
контрольн точк => контрольная точка
конфиденциальн дан => конфиденциальность данных
координатн коммутатор => координатный коммутатор
координатн переключател => координатный переключатель
копирован при запис => копирование при записи
корнев файлов систем => корневая файловая система
корнев каталог => корневой каталог
корнев ключ => корневой ключ
кортеж => кортеж
косвен => косвенность
косвен блок => косвенный блок
красн книг => Красная книга
кратчайш задач — перв => кратчайшая задача — первая
криптограф => криптография
критическ област => критическая область
критическ секц => критическая секция
куб => куб
кэш => кэш
кэш со сквозн запис => кэш со сквозной записью
кэш-памя => кэш-память
кэш-строк => кэш-строка
кэширован => кэширование
кэширован window => кэширование Windows
кэширован мультимед => кэширование мультимедиа
кэширован файл => кэширование файл
кэширован файлов => кэширование файловое
линейн адрес => линейный адрес
лин последовательн передач => линия последовательной передачи
логическ адресац блок => логическая адресация блоков
логическ архивац => логическая архивация
логическ бомб => логическая бомба
ложн совместн использован памят => ложное совместное использование памяти
локальн сет => локальная сеть
локальн таблиц дескриптор => локальная таблица дескрипторов
локальн => локальность
локальн обращен => локальность обращений
лотерейн планирован => лотерейное планирование
магазин алгоритм => магазинный алгоритм
магическ числ => магическое число
макроблок => макроблок
маркер доступ => маркер доступа
маршрутизатор => маршрутизатор
матриц защит => матрица защиты
машин с конечн числ состоян => машина с конечным числом состояний
машин язык => машинный язык
международн союз телекоммуникац itu => международный союз телекоммуникаций ITU
международн стандарт IS 9660 => международный стандарт IS 9660
межпроцессн взаимодейств => межпроцессное взаимодействие
менеджер plug-and-plai => менеджер plug-and-play
менеджер безопасност => менеджер безопасности
менеджер ввода-вывод => менеджер ввода-вывода
менеджер вызов локальн процедур => менеджер вызова локальной процедуры
менеджер конфигурац => менеджер конфигурации
менеджер кэш => менеджер кэша
менеджер объект => менеджер объектов
менеджер памят => менеджер памяти
менеджер памят window => менеджер памяти Windows
менеджер процесс => менеджер процессов
менеджер энергопотреблен => менеджер энергопотребления
метафайл => метафайл
метод => метод
метод груб сил => метод грубой силы
механизм защит => механизм защиты
механизм и политик => механизм и политика
механизм планирован => механизм планирования
микроархитектурн уровен => микроархитектурный уровень
микрокомпьютер => микрокомпьютер
микропрограмм => микропрограмма
микроядр => микроядро
мифическ человеко-месяц => Мифический человеко-месяц
младш устройств => младшее устройство
многозадачн => многозадачность
многозадачн моделирован => многозадачность моделирование
многозадачн степен => многозадачность степень
многозадачн фиксирова раздел => многозадачность фиксированные разделы
многомашин систем => многомашинная система
многомашин систем аппаратн обеспечен => многомашинная система аппаратное обеспечение
многомашин систем планирован => многомашинная система планирование
многомашин систем программн обеспечен => многомашинная система программное обеспечение
многомашин систем соединительн сет => многомашинная система соединительная сеть
многопоточн программ => многопоточная программа
многопоточн => многопоточность
многопоточн процесс => многопоточный процесс
многопроцессорн систем => многопроцессорная система
многоступенчат коммутаторн сет => многоступенчатые коммутаторные сети
многоуровнев защит => многоуровневая защита
многоуровнев систем => многоуровневая система
многоуровнев систем безопасност => многоуровневая система безопасности
мобильн программ => мобильная программа
моделирован => моделирование
моделирован взаимоблокировок => моделирование взаимоблокировок
моделирован страничн организац памят => моделирование страничной организации памяти
модел белла-л падул => модель Белла-Ла Падулы
модел биб => модель Биба
модел клиент-сервер => модель клиент-сервер
модел поток => модель потока
модел процесс => модель процессов
модел рабоч набор => модель рабочего набора
модул управлен памят => модуль управления памятью
монитор => монитор
монитор виртуальн машин => монитор виртуальной машины
монитор обращен => монитор обращений
моноалфавитн подстановк => моноалфавитная подстановка
моноалфавитн подстановочн шифр => моноалфавитный подстановочный шифр
монолитн систем => монолитная система
монтирован файлов систем => монтирование файловой системы
мост => мост
мультикомпьютер => мультикомпьютер
мультимедийн систем => мультимедийная система
мультимедийн систем алгоритм планирован => мультимедийная система алгоритмы планирования
мультимедийн систем дисков планирован => мультимедийная система дисковое планирование
мультимедийн систем парадигм файлов систем => мультимедийная система парадигмы файловой системы
мультимедийн систем размещен файл => мультимедийная система размещение файлов
мультимедийн систем сервер => мультимедийная система сервер
мультимедийн систем сжат дан => мультимедийная система сжатие данных
мультимедийн систем файл => мультимедийная система файл
мультипрограммирован => мультипрограммирование
мультипроцессор => мультипроцессор
мультипроцессор cc-numa => мультипроцессор CC-NUMA
мультипроцессор nc-numa => мультипроцессор NC-NUMA
мультипроцессор numa => мультипроцессор NUMA
мультипроцессор аппаратн обеспечен => мультипроцессор аппаратное обеспечение
мультипроцессор каталогов => мультипроцессор каталоговый
мультипроцессор координатн коммутатор => мультипроцессор координатный коммутатор
мультипроцессор многоступенчат сет => мультипроцессор многоступенчатая сеть
мультипроцессор общ шин => мультипроцессор общая шина
мультипроцессор операцион систем => мультипроцессор операционная система
мультипроцессор планирован => мультипроцессор планирование
мультипроцессор с общ памят => мультипроцессор с общей памятью
мультипроцессор синхронизац => мультипроцессор синхронизация
мусорн корзин => мусорная корзина
мутацион движущ механизм => мутационный движущий механизм
мьютекс => мьютекс
мэйнфрейм => мэйнфрейм
мягк таймер => мягкий таймер
надежн систем => надежная система
надежн служб => надежная служба
надежн => надежность
надежн алгоритм хэширован sha => надежный алгоритм хэширования SHA
наименьш оста врем выполнен => наименьшее оставшееся время выполнения
настройк адрес => настройка адресов
небезопасн состоян => небезопасное состояние
неблокир сет => неблокирующая сеть
неблокир выз => неблокирующий вызов
недоста блок диск => недостающий блок диска
независим от местоположен => независимость от местоположения
независим от устройств => независимость от устройств
неканоническ реж => неканонический режим
необратим функц => необратимая функция
непериодическ процесс => непериодический процесс
непосредствен файл => непосредственный файл
неприоритетн планирован => неприоритетное планирование
неприятел => неприятель
нерезидентн атрибут => нерезидентный атрибут
неточн прерыван => неточное прерывание
обнаружен взаимоблокировк => обнаружение взаимоблокировки
оболочк => оболочка
оборотн врем => оборотное время
обработа символьн поток => обработанный символьный поток
обработк ошибок => обработка ошибок
обработк страничн прерыван => обработка страничного прерывания
образ памят => образ памяти
обратн выз => обратный вызов
обслужива процесс => обслуживающий процесс
общ прав => общие права
объект арс => объект АРС
объект dpc => объект DPC
объект window => объект Windows
объект безопасн => объект безопасность
объект диспетчеризац => объект диспетчеризации
объект драйвер => объект драйвера
объект устройств => объект устройства
оверл => оверлей
одинарн косвен блок => одинарный косвенный блок
однозадачн систем => однозадачная система
одноразов парол => одноразовый пароль
ожидан готовност => ожидание готовности
оз => ОЗУ
оклик-отз => оклик-отзыв
окн => окно
окон расширен адрес => оконные расширения адреса
окон менеджер => оконный менеджер
онтогенез повторя филогенез => онтогенез повторяет филогенез
оперативн памя => оперативная память
оперативн запомина устройств => оперативное запоминающее устройство
операц с каталог => операции с каталогами
операцион систем => операционная система
операцион систем minix => операционная система MINIX
операцион систем multic => операционная система MULTICS
операцион систем unic => операционная система UNICS
операцион систем unix => операционная система UNIX
операцион систем встроен => операционная система встроенная
операцион систем истор => операционная система история
операцион систем менеджер ресурс => операционная система менеджер ресурсов
операцион систем мультимедийн => операционная система мультимедийная
операцион систем мультипроцессор => операционная система мультипроцессор
операцион систем пакетн обработк => операционная система пакетная обработка
операцион систем понят => операционная система понятия
операцион систем производительн => операционная система производительность
операцион систем разработк => операционная система разработка
операцион систем расширен машин => операционная система расширенная машина
операцион систем реализац => операционная система реализация
операцион систем реальн времен => операционная система реального времени
операцион систем смарт-карт => операционная система смарт-карта
операцион систем структур => операционная система структура
операцион систем тенденц => операционная система тенденции
операцион систем тип => операционная система типы
опережа подкачк страниц => опережающая подкачка страниц
опережа чтен => опережающее чтение
опережа чтен блок => опережающее чтение блока
описател виртуальн памят => описатель виртуальной памяти
опрос => опрос
оптимальн алгоритм замещен страниц => оптимальный алгоритм замещения страниц
оптимизац => оптимизация
оптимизац общ случа => оптимизация общий случай
оптимизац по памят => оптимизация по памяти
оптимизац по скорост => оптимизация по скорости
оптическ диск => оптический диск
оп => опыт
оранжев книг => Оранжевая книга
организац дисков пространств => организация дискового пространства
организац файл => организация файла
орга алгоритм => органный алгоритм
ориентирова ациклическ граф => ориентированный ациклический граф
ортогональн => ортогональность
основн описател том => основной описатель тома
отказ в обслуживан => отказ в обслуживании
открыт текст => открытый текст
отложен выз процедур => отложенный вызов процедуры
относительн им пут => относительное имя пути
относительн пут => относительный путь
отобража на памя ввод-вывод => отображаемый на память ввод-вывод
отображен файл на адресн пространств памят => отображение файла на адресное пространство памяти
отпечатк пальц => отпечатки пальцев
ошибк из-з отсутств страниц => ошибка из-за отсутствия страницы
пакет => пакет
пакет запрос ввода-вывод => пакет запроса ввода-вывода
пакетн обработк => пакетная обработка
пакетн реж => пакетный режим
памя => память
панац нет => Панацеи нет
панаце => Панацея
папк => папка
парадигм алгоритмическ => парадигма алгоритмическая
парадигм дан => парадигма данных
парадигм интерфейс пользовател => парадигма интерфейса пользователя
парадигм исполнен => парадигма исполнения
парадигм управлен событ => парадигма управления событиями
параллельн и распределен систем => параллельные и распределенные системы
парол => пароль
парол одноразов => пароль одноразовый
перв пришел — перв обслуж => первым пришел — первым обслужен
перевоплощен => перевоплощение
передач сообщен => передача сообщений
передач сообщен производител и потребител => передача сообщений производитель и потребитель
передач сообщен разработк сист => передача сообщений разработка систем
перезапуск прерва команд процессор => перезапуск прерванной команды процессора
переключен банк памят => переключение банков памяти
переключен контекст => переключение контекста
переключен процесс => переключение процессов
перекос головок => перекос головок
перекос цилиндр => перекос цилиндров
перекрыва поиск => перекрывающийся поиск
перемен состоян => переменная состояния
перемещен программ в памят => перемещение программ в памяти
перенаправлен => перенаправление
переносим компилятор язык с => переносимый компилятор языка С
перечен возможност => перечень возможностей
периодическ процесс => периодический процесс
персистентн => персистентность
песочниц => песочница
петерсон алгоритм => Петерсона алгоритм
пзу => ПЗУ
пиксел => пиксел
пит => пит
планирован => планирование
планирован rm => планирование RMS
планирован без переключен => планирование без переключений
планирован неприоритетн => планирование неприоритетное
планирован перемещен головок => планирование перемещения головок
планирован перемещен головок алгоритм ssf => планирование перемещения головок алгоритм SSF
планирован перемещен головок элеваторн алгоритм => планирование перемещения головок элеваторный алгоритм
планирован поток => планирование потоков
планирован приоритетн => планирование приоритетное
планирован процесс => планирование процессов
планирован процесс мультимед => планирование процессов мультимедиа
планирован реальн времен => планирование реального времени
планирован с нескольк очеред => планирование с несколькими очередями
планирован с переключен => планирование с переключениями
планирован с постоя скорост => планирование с постоянной скоростью
планировщик => планировщик
планировщик памят => планировщик памяти
планируем систем => планируемая система
повторн использован => повторное использование
повторн использован ид => повторное использование идей
подгружа модул => подгружаемый модуль
подкачк => подкачка
подкачк страниц => подкачка страниц
подключ => подключ
подписан программ => подписание программ
подсистем окружен => подсистема окружения
подсказк => подсказка
подтвержден => подтверждение
поздн связыван => позднее связывание
позиционо-независим код => позиционно-независимый код
поиск файл по имен => поиск файла по имени
поклеточн разбивк => поклеточная разбивка
пол => поле
политик и механизм => политика и механизм
политик очистк страниц => политика очистки страниц
политик планирован => политика планирования
пользовательск реж => пользовательский режим
порт ввода-вывод => порт ввода-вывода
последовательн непротиворечив => последовательная непротиворечивость
последовательн доступ => последовательный доступ
последовательн процесс => последовательный процесс
посредническ обеспечен => посредническое обеспечение
постоя запомина устройств => постоянное запоминающее устройство
постоя шаг времен => постоянный шаг времени
постоя шаг дан => постоянный шаг данных
потайн двер => потайная дверь
поток => поток
поток linux => поток Linux
поток unix => поток UNIX
поток window => поток Windows
поток всплыва => поток всплывающий
поток дан => поток данных
поток пользовател => поток пользователь
поток рабоч => поток рабочий
поток реализац => поток реализация
поток смеша реализац => поток смешанная реализация
поток упаковк => поток упаковка
поток управля ядр => поток управляемый ядром
поток чехол => поток чехол
поток ядр => поток ядра
почт виде по заказ => почти видео по заказу
почт виде по заказ размещен файл => почти видео по заказу размещение файлов
почтов ящик => почтовый ящик
прав доступ => право доступа
преамбул => преамбула
предельн регистр => предельный регистр
предотвращен взаимоблокировок => предотвращение взаимоблокировок
предотвращен взаимоблокировок атак услов => предотвращение взаимоблокировок атака условия
предотвращен взаимоблокировок услов отсутств принудительн выгрузк ресурс => предотвращение взаимоблокировок условие отсутствия принудительной выгрузки ресурса
предотвращен тупик => предотвращение тупиков
прерыван => прерывание
прерыван неточн => прерывание неточное
прерыван точн => прерывание точное
префиксн символ => префиксный символ
приглашен => приглашение
приглашен к ввод => приглашение к вводу
примит P и V => примитив P и V
примит receiv => примитив receive
примит send => примитив send
примит sleep => примитив sleep
примит wakeup => примитив wakeup
принудительн управлен доступ => принудительное управление доступом
принцип наименьш уровн привилег => принцип наименьшего уровня привилегий
принципа => принципал
принцип проектирован сист безопасност => принципы проектирования систем безопасности
принцип разработк => принципы разработки
приоритетн планирован => приоритетное планирование
пришпиливан страниц => пришпиливание страницы
приятельск алгоритм => приятельский алгоритм
проблем межпроцессн взаимодейств => проблема межпроцессного взаимодействия
проблем межпроцессн взаимодейств обеда философ => проблема межпроцессного взаимодействия обедающие философы
проблем межпроцессн взаимодейств спящ брадобр => проблема межпроцессного взаимодействия спящий брадобрей
проблем межпроцессн взаимодейств читател и писател => проблема межпроцессного взаимодействия читатели и писатели
проблем обеда философ => проблема обедающих философов
проблем огражден => проблема ограждения
проблем ограничен буфер => проблема ограниченного буфера
проблем производител и потребител => проблема производителя и потребителя
проблем производител и потребител монитор => проблема производителя и потребителя монитор
проблем производител и потребител передач сообщен => проблема производителя и потребителя передача сообщений
проблем производител и потребител семафор => проблема производителя и потребителя семафор
проблем спящ брадобре => проблема спящего брадобрея
проблем читател и писател => проблема читателей и писателей
пробуксовыван => пробуксовывание
программн обеспечен ввода-вывод => программное обеспечение ввода-вывода
программн обеспечен ввода-вывод gui => программное обеспечение ввода-вывода GUI
программн обеспечен ввода-вывод unix => программное обеспечение ввода-вывода UNIX
программн обеспечен ввода-вывод window => программное обеспечение ввода-вывода Windows
программн обеспечен ввода-вывод буферизац => программное обеспечение ввода-вывода буферизация
программн обеспечен ввода-вывод ввод => программное обеспечение ввода-вывода ввод
программн обеспечен ввода-вывод вывод => программное обеспечение ввода-вывода вывод
программн обеспечен ввода-вывод именован => программное обеспечение ввода-вывода именование
программн обеспечен ввода-вывод независим от устройств => программное обеспечение ввода-вывода независимое от устройств
программн обеспечен ввода-вывод обработк ошибок => программное обеспечение ввода-вывода обработка ошибок
программн обеспечен ввода-вывод пространств пользовател => программное обеспечение ввода-вывода пространства пользователя
программн обеспечен ввода-вывод синхрон => программное обеспечение ввода-вывода синхронное
программн обеспечен ввода-вывод сообщен об ошибк => программное обеспечение ввода-вывода сообщения об ошибках
программн обеспечен ввода-вывод термина => программное обеспечение ввода-вывода терминал
программн обеспечен ввода-вывод уровн => программное обеспечение ввода-вывода уровни
программн обеспечен таймер => программное обеспечение таймеров
программн ввод-вывод => программный ввод-вывод
программн сегмент => программный сегмент
прозрачн именован => прозрачность именования
прозрачн местоположен => прозрачность местоположения
производительн операцион систем => производительность операционная система
производительн файлов систем => производительность файловая система
произвольн доступ => произвольный доступ
промежуточн программн обеспечен => промежуточное программное обеспечение
промежуточн программн обеспечен документн => промежуточное программное обеспечение документное
промежуточн программн обеспечен координац => промежуточное программное обеспечение координация
промежуточн программн обеспечен совместн используем объект => промежуточное программное обеспечение совместно используемый объект
промежуточн программн обеспечен файлов систем => промежуточное программное обеспечение файловая система
пропускн способн => пропускная способность
просмотр программ => просмотр программ
пространств им объект => пространство имен объектов
пространств кортеж => пространство кортежей
протокол => протокол
протокол IP => протокол IP
протокол tcp => протокол TCP
протокол udr => протокол UDR
процесс unix => процесс UNIX
процесс window => процесс Windows
процесс дочерн => процесс дочерний
процесс межпроцессн взаимодейств => процесс межпроцессное взаимодействие
процесс непериодическ => процесс непериодический
процесс периодическ => процесс периодический
процесс проблем межпроцессн взаимодейств => процесс проблемы межпроцессного взаимодействия
процесс родительск => процесс родительский
прям доступ к памят => прямой доступ к памяти
псевдопараллелизм => псевдопараллелизм
публикация/подписк => публикация/подписка
пул-сервер => пул-сервер
пуш-сервер => пуш-сервер
работ в сет => работа в сети
рабоч uid => рабочий UID
рабоч каталог => рабочий каталог
рабоч набор => рабочий набор
рабоч поток => рабочий поток
раздел диск => раздел диска
разделен времен => разделение времени
разделен пространств => разделение пространства
разделен процессор => разделение процессора
размер блок => размер блока
размер кластер => размер кластера
размер страниц => размер страницы
размещен файл fat-таблиц => размещение файлов FAT-таблица
размещен файл мультимед => размещение файлов мультимедиа
размещен файл почт виде по заказ => размещение файлов почти видео по заказу
размещен файл связн список => размещение файлов связный список
разработк => разработка
рандев => рандеву
ран связыван => раннее связывание
распределен операцион систем => распределенная операционная система
распределен памя совместн доступ => распределенная память совместного доступа
распределен систем => распределенная система
распределен => распределенный
растров график => растровая графика
растров изображен => растровое изображение
расширен файл => расширение файла
расширен joliet => расширения Joliet
расширен рок-ридж => расширения Рок-Ридж
расширен машин => расширенная машина
расширя систем => расширяемая система
раунд => раунд
реализац процесс => реализация процессов
реализац сверх вниз => реализация сверху вниз
реализац сниз вверх => реализация снизу вверх
регистр устройств => регистр устройства
регулярн файл => регулярный файл
реентерабельн программ => реентерабельная программа
реентерабельн => реентерабельность
реестр => реестр
реж без обработк => режим без обработки
реж пользовател => режим пользователя
реж разделен времен => режим разделения времени
реж с обработк => режим с обработкой
реж супервизор => режим супервизора
реж ядр => режим ядра
резервн коп => резервная копия
результативн обращен к кэш-памят => результативное обращение к кэш-памяти
репликац => репликация
ресурс => ресурс
ресурс выгружа => ресурс выгружаемый
ресурс невыгружа => ресурс невыгружаемый
ресурс получен => ресурс получение
решетк => решетка
родительск процесс => родительский процесс
родствен планирован => родственное планирование
рок-ридж расширен => Рок-Ридж расширения
рол => роль
сбо => сбой
сбо процесс => сбой процесса
свопер => свопер
свопинг => свопинг
свопинг unix => свопинг UNIX
связн список => связный список
связ программн обеспечен => связующее программное обеспечение
связ => связь
сеансов семантик => сеансовая семантика
сеансов менеджер => сеансовый менеджер
сегмент => сегмент
сегмент bss => сегмент BSS
сегмент дан => сегмент данных
сегмент стек => сегмент стека
сегментац => сегментация
сегментац multic => сегментация MULTICS
сегментац pentium => сегментация Pentium
сегментац реализац => сегментация реализация
секретн благодар неизвестност => секретность благодаря неизвестности
селектор => селектор
семантик совместн использован файл => семантика совместного использования файлов
семафор => семафор
семафор двоичн => семафор двоичный
сервер без состоян => сервер без состояния
серверн процесс => серверный процесс
серверн суррогат => серверный суррогат
сертификат => сертификат
сетев служб => сетевая служба
сетев служб без установлен соединен => сетевая служба без установления соединения
сетев служб дейтаграмм => сетевая служба дейтаграмм
сетев служб с подтвержден => сетевая служба с подтверждениями
сетев служб запрос и ответ => сетевая служба запросов и ответов
сетев служб ориентирова на соединен => сетевая служба ориентированная на соединение
сетев аппаратн обеспечен => сетевое аппаратное обеспечение
сетев анализатор пакет => сетевой анализатор пакетов
сетев интерфейс => сетевой интерфейс
сетев протокол => сетевой протокол
сетев термина => сетевой терминал
сетев термина sum => сетевой терминал SUM
сет unix => сеть UNIX
сет омег => сеть омега
сжат дан => сжатие данных
сжат дан с потер => сжатие данных с потерями
сжат памят => сжатие памяти
сжат файл => сжатие файлов
сигна => сигнал
сигна тревог => сигнал тревоги
сигнатурн блок => сигнатурный блок
сильносвяза систем => сильносвязанная система
символ звездочк => символ звездочки
символ кана => символ канала
символьн связыван => символьное связывание
символьн устройств => символьное устройство
символьн специальн файл => символьный специальный файл
симметричн мультипроцессор => симметричный мультипроцессор
синхронизац => синхронизация
синхронизац мультипроцессор => синхронизация мультипроцессор
синхрон выз => синхронный вызов
систем клиент-сервер => система клиент-сервер
систем пакетн обработк => система пакетной обработки
систем подда планирован => система поддающаяся планированию
систем шифрован файл => система шифрования файлов
системн служб => системные службы
системн выз => системный вызов
системн выз безопасн => системный вызов безопасность
системн выз ввод-вывод => системный вызов ввод-вывод
системн выз пример использован => системный вызов пример использования
системн выз управлен => системный вызов управление
системн выз файлов систем => системный вызов файловой системы
системн список контрол доступ => системный список контроля доступа
сквозн аргумент => сквозной аргумент
сквозн кэш => сквозной кэш
сквозн реж => сквозной режим
скелет => скелет
слабосвяза систем => слабосвязанная система
слов состоян процессор => слово состояния процессора
служб им домен => служба имен доменов
служб обнаружен => служба обнаружения
смарт-карт => смарт-карта
событ => событие
совместн используем страниц => совместно используемые страницы
совместн использован пространств => совместное использование пространства
совместн использован файл => совместное использование файлов
создан процесс => создание процесса
сокет => сокет
сокрыт аппаратур => сокрытие аппаратуры
сол => соль
сообщен об ошибк => сообщения об ошибках
соразмерн => соразмерность
состоян зомб => состояние зомби
состоян процесс => состояние процесса
состоян состязан => состояние состязания
специальн файл => специальный файл
специальн файл блочн => специальный файл блочный
специальн файл символьн => специальный файл символьный
спин-блокировк => спин-блокировка
список разграничительн контрол доступ => список разграничительного контроля доступа
список управлен доступ => список управления доступом
справедлив планирован => справедливое планирование
спулинг => спулинг
стабильн запомина устройств => стабильное запоминающее устройство
стандарт ieee 1003.1 => стандарт IEEE 1003.1
стандарт jpeg => стандарт JPEG
стандарт mpeg => стандарт MPEG
стандарт posix => стандарт POSIX
стандарт svid => стандарт SVID
стандарт шифрован дан => стандарт шифрования данных
стандартн устройств ввод => стандартное устройство ввода
стандартн устройств вывод => стандартное устройство вывода
стандартн устройств вывод сообщен об ошибк => стандартное устройство вывода сообщений об ошибках
старен => старение
старш устройств => старшее устройство
статическ и динамическ структур => статические и динамические структуры
стеганограф => стеганография
стек протокол => стек протоколов
степен многозадачност => степень многозадачности
сторожев таймер => сторожевой таймер
страниц => страница
страниц пришпиливан => страница пришпиливание
страничн организац памят => страничная организация памяти
страничн организац памят вопрос => страничная организация памяти вопросы
страничн организац памят глобальн => страничная организация памяти глобальная
страничн организац памят локальн => страничная организация памяти локальная
страничн организац памят моделирован => страничная организация памяти моделирование
страничн организац памят регулирован загрузк => страничная организация памяти регулирование загрузки
страничн подкачк => страничная подкачка
страничн прерыван => страничное прерывание
страничн блок => страничный блок
страничн демон => страничный демон
страничн каталог => страничный каталог
страусов алгоритм => страусовый алгоритм
строк кэш => строка кэша
строк обращен => строка обращений
строк расстоян => строка расстояний
структур команд => структура команды
структур операцион систем => структура операционной системы
структур пользовател => структура пользователя
структур файл => структура файла
субъект => субъект
суперблок => суперблок
суперпользовател => суперпользователь
суперскалярн центральн процессор => суперскалярный центральный процессор
суррогат => суррогат
сценар оболочк => сценарий оболочки
счетчик команд => счетчик команд
сыр реж => сырой режим
таблиц i-узл => таблица i-узлов
таблиц открыт файл => таблица открытых файлов
таблиц поток => таблица потоков
таблиц процесс => таблица процессов
таблиц процесс unix => таблица процессов UNIX
размещен файл fat-16 => размещения файлов FAT-16
размещен файл fat-32 => размещения файлов FAT-32
таблиц страниц => таблица страниц
таблиц страниц инвертирова => таблица страниц инвертированная
таблиц страниц многоуровнев => таблица страниц многоуровневая
таблиц страниц структур => таблица страниц структура
таблиц страниц элемент => таблица страниц элемент
таймер => таймер
тайн кана => тайный канал
тегов архитектур => теговая архитектура
текстов сегмент => текстовый сегмент
текстов сегмент совместн использован => текстовый сегмент совместного использования
текущ виртуальн врем => текущее виртуальное время
текущ каталог => текущий каталог
текущ приоритет => текущий приоритет
телевиден => телевидение
телевизион приставк => телевизионная приставка
тенденц в проектирован операцион сист => тенденции в проектировании операционных систем
термина => терминал
термина rs-232 => терминал RS-232
термина ввод => терминал ввода
термина вывод => терминал вывода
термина сетев => терминал сетевой
тик => тик
тип файл => тип файла
томпсон => Томпсон
«тонкий» клиент => «тонкий» клиент
торвальдс => Торвальдс
точк воспроизведен => точка воспроизведения
точк повторн анализ => точка повторного анализа
точн прерыван => точное прерывание
траектор ресурс => траектории ресурсов
трамплин => трамплин
трехуровнев планирован => трехуровневое планирование
тройн косвен блок => тройной косвенный блок
троянск кон => троянский конь
труб => труба
тупик => тупик
тупик без ресурс => тупик без ресурсов
тупиков ситуац => тупиковая ситуация
угроз => угроза
узк чередован => узкое чередование
указател стек => указатель стека
ул => улей
умн планирован => умное планирование
унаследова устройств => унаследованное устройство
универсальн асинхрон приемопередатчик => универсальный асинхронный приемопередатчик
унифицирова указател информацион ресурс => унифицированный указатель информационного ресурса
уплотнен памят => уплотнение памяти
управлен памят => управление памятью
управлен памят linux => управление памятью Linux
управлен памят unix => управление памятью UNIX
управлен памят window => управление памятью Windows
управлен памят битов масс => управление памятью битовый массив
управлен памят виртуальн памя => управление памятью виртуальная память
управлен памят вопрос разработк => управление памятью вопросы разработки
управлен памят вопрос реализац => управление памятью вопросы реализации
управлен памят свопинг => управление памятью свопинг
управлен памят связн список => управление памятью связный список
управлен памят сегментац => управление памятью сегментация
управлен памят системн вызов => управление памятью системные вызовы
управлен проект => управление проектом
управлен процесс в unix => управление процессами в UNIX
управлен режим энергопотреблен => управление режимом энергопотребления
управлен режим энергопотреблен аппаратн аспект => управление режимом энергопотребления аппаратный аспект
управлен режим энергопотреблен аспект операцион систем => управление режимом энергопотребления аспект операционной системы
управлен режим энергопотреблен частичн функционирован => управление режимом энергопотребления частичное функционирование
управлен состоян батар => управление состоянием батарей
управлен температурн режим => управление температурным режимом
управлен физическ памят => управление физической памятью
управля прерыван ввод-вывод => управляемый прерываниями ввод-вывод
управля функц видеомагнитофон => управляющие функции видеомагнитофона
управля объект => управляющий объект
упрощен процесс => упрощенный процесс
уровен hal => уровень HAL
уровен аппаратн абстракц => уровень аппаратных абстракций
уровен архитектур систем команд => уровень архитектуры системы команд
услов циклическ ожидан => условие циклического ожидания
устойчив => устойчивость
устройств ввода-вывод => устройство ввода-вывода
участок обращен => участок обращений
учет свободн блок диск => учет свободных блоков диска
файл => файл
файл атрибут => файл атрибут
файл дескриптор => файл дескриптор
файл непрерывн => файл непрерывный
файл операц => файл операции
файл опережа чтен блок => файл опережающее чтение блока
файл размер блок => файл размер блока
файл реализац => файл реализация
файл совместн использован => файл совместное использование
файл специальн => файл специальный
файл структур => файл структура
файлов систем => файловая система
файлов систем af => файловая система AFS
файлов систем berkelei fast => файловая система Berkeley Fast
файлов систем cd-rom => файловая система CD-ROM
файлов систем ср/м => файловая система СР/М
файлов систем fat-16 => файловая система FAT-16
файлов систем fat-32 => файловая система FAT-32
файлов систем iso 9660 => файловая система ISO 9660
файлов систем linux => файловая система Linux
файлов систем ms-do => файловая система MS-DOS
файлов систем nf => файловая система NFS
файлов систем ntf => файловая система NTFS
файлов систем unix => файловая система UNIX
файлов систем unix реализац => файловая система UNIX реализация
файлов систем unixv7 => файловая система UNIXV7
файлов систем window => файловая система Windows
файлов систем window 98 => файловая система Windows 98
файлов систем архивац => файловая система архивация
файлов систем вызов win32 api => файловая система вызовы Win32 API
файлов систем дисков квот => файловая система дисковая квота
файлов систем мультимед => файловая система мультимедиа
файлов систем надежн => файловая система надежность
файлов систем непротиворечив => файловая система непротиворечивость
файлов систем пример => файловая система примеры
файлов систем распределен => файловая система распределенная
файлов систем реализац => файловая система реализация
файлов систем с журнальн структур => файловая система с журнальной структурой
файлов систем системн вызов unix => файловая система системные вызовы UNIX
файлов систем структур => файловая система структура
файлов кэширован => файловое кэширование
фальшив программ регистрац => фальшивая программа регистрации
физическ архивац => физическая архивация
физическ адрес => физический адрес
фиксирова раздел => фиксированные разделы
фильтр => фильтр
фильтр драйвер => фильтрующий драйвер
флаг => флаг
флэш-оз => флэш-ОЗУ
фонд открыт программн обеспечен => фонд открытого программного обеспечения
формальн модел защищен сист => формальные модели защищенных систем
форматирован диск => форматирование диска
фортра => Фортран
фрагментац => фрагментация
фрагментац внешн => фрагментация внешняя
фрагментац внутрен => фрагментация внутренняя
хакер => хакер
хост => хост
хранен страничн памят на диск => хранение страничной памяти на диске
цветност => цветность
цветов палитр => цветовая палитра
целостн дан => целостность данных
центральн процессор => центральный процессор
циклическ ожидан => циклическое ожидание
циклическ планирован => циклическое планирование
ципф закон => Ципфа закон
цифров подп => цифровая подпись
цифров виде => цифровое видео
частот страничн прерыван => частота страничных прерываний
час => часы
час генератор прямоугольн импульс => часы генератор прямоугольных импульсов
час реж одновибратор => часы режим одновибратора
час тик => часы тик
черв => червь
червячн маршрутизац => червячная маршрутизация
чередован диск => чередование диск
чередован сектор => чередование секторов
черед набор => чередующийся набор
чересстрочн развертк => чересстрочная развертка
чистя поток => чистящий поток
шаблон => шаблон
шин => шина
шин isa => шина ISA
шин pci => шина PCI
шин scsi => шина SCSI
шин usb => шина USB
широк чередован => широкое чередование
шифрован => шифрование
шифрован с открыт ключ => шифрование с открытым ключом
шифрован с секретн ключ => шифрование с секретным ключом
шифрован с симметричн ключ => шифрование с симметричным ключом
шифрован файл => шифрование файлов
шифр файлов систем => шифрующая файловая система
шлюз вызов => шлюз вызова
шрифт => шрифт
шум квантован => шум квантования
экзоядр => экзоядро
элеваторн алгоритм => элеваторный алгоритм
электрическ стира пзу => электрически стираемое ПЗУ
элемент списк контрол доступ => элемент списка контроля доступа
элементарн действ => элементарное действие
эмулирова прерыван => эмулированное прерывание
энергонезависим оз => энергонезависимое ОЗУ
эффект втор систем => эффект второй системы
эхопеча => эхопечать
ядр => ядро
ядр unix => ядро UNIX
ядр window => ядро Windows
яркост => яркость